[
----------------------------------------|
-        -     *********          *   *-|
-        -             *          *   *-|
-        - -  --------    --***--     *-|
-        ---------------------------* *-|
------   -                          * *-|
-****    -            --            * *-|
-        - --    --       --   --   * *-|
-        -                             -|
-**   *---***    ****************----**-|
-        -   *  *                      -|
-       *-                             -|
-        -                             -|
------  *-                             -|
-****    -                             -|
-*  *   *-                             -|
-*       -                             -|
----------                             -|
-***     -                             -|
-* *     -                             -|
-* *  -* -                             -|
-* * --* -                             -|
-*   -   -                             -|
------   -                             -|
-***     -*--                          -|
-     ----------------------------------|
-    *        - *       --             -|
-         -     *   --  -- -- *        -|
-       * - * -   * --*    --   * -*   -|
----------------------------------------|
]






/